あなかりす	アナカリス	人名
ひつぎのまい	棺の舞	固有名詞
おうけのさばき	王家の裁き	固有名詞
ことだまがえし	言霊返し	固有名詞
こぶらぶろー	コブラブロー	固有名詞
みいらどろっぷ	ミイラドロップ	固有名詞
とがめのあな	咎めの穴	固有名詞
しんじつのおしえ	真実の教え	固有名詞
ならくのあな	奈落の穴	固有名詞
ふぁらおまじっく	ファラオマジック	固有名詞
ふぁらおさるべーしょん	ファラオサルベーション	固有名詞
ふぁらおでこれーしょん	ファラオデコレーション	固有名詞
ふぁらおすぷりっと	ファラオスプリット	固有名詞
おるばす	オルバス	人名
そにっくうぇーぶ	ソニックウェーブ	固有名詞
ぽいずんぶれす	ポイズンブレス	固有名詞
とりっくふぃっしゅ	トリックフィッシュ	固有名詞
くりすたるらんさー	クリスタルランサー	固有名詞
じぇむずあんがー	ジェムズアンガー	固有名詞
しーれいじ	シーレイジ	固有名詞
あくあすぷれっど	アクアスプレッド	固有名詞
うぉーたーじぇいる	ウォータージェイル	固有名詞
だいれくとしざーず	ダイレクトシザーズ	固有名詞
おーしゃんれいじ	オーシャンレイジ	固有名詞
びしゃもん	ビシャモン	人名
いあいぎり	居合い斬り	固有名詞
きえんざん	鬼炎斬	固有名詞
きりすてごめん	切り捨て御免	固有名詞
からめだま	絡め魂	固有名詞
たまよせ	魂寄せ	固有名詞
つじはやて	辻疾風	固有名詞
おにくびひねり	鬼首捻り	固有名詞
えんまいし	閻魔石	固有名詞
とがくびさらし	とが首さらし	固有名詞
こがねかたびら	黄金帷子	固有名詞
ばれった	バレッタ	人名
すまいるあんどみさいる	スマイル&ミサイル	固有名詞
はっぴーあんどみさいる	ハッピー&ミサイル	固有名詞
ちあーあんどふぁいあ	チアー&ファイア	固有名詞
しゃいねすあんどすとらいく	シャイネス&ストライク	固有名詞
じぇらしーあんどふぇいく	ジェラシー&フェイク	固有名詞
せんちめんたるたいふーん	センチメンタルタイフーン	固有名詞
くーるはんてぃんぐ	クールハンティング	固有名詞
びゅーてぃふるめもりー	ビューティフルメモリー	固有名詞
あっぷるふぉーゆー	アップルフォーユー	固有名詞
ざきりんぐたいむ	ザ・キリングタイム	固有名詞
でみとり	デミトリ	名
まきしもふ	マキシモフ	姓
でみとりまきしもふ	デミトリ=マキシモフ	人名
かおすふれあ	カオスフレア	固有名詞
でもんくれいどる	デモンクレイドル	固有名詞
ばっとすぴん	バットスピン	固有名詞
ねがてぃぶすとーれん	ネガティブストーレン	固有名詞
みっどないとぶりす	ミッドナイトブリス	固有名詞
でもんびりおん	デモンビリオン	固有名詞
みっどないとぷれじゃー	ミッドナイトプレジャー	固有名詞
だーくさいどますたー	ダークサイドマスター	固有名詞
ふぇりしあ	フェリシア	人名
ろーりんぐばっくらー	ローリングバックラー	固有名詞
きゃっとすぱいく	キャットスパイク	固有名詞
でるたきっく	デルタキック	固有名詞
へるきゃっと	ヘルキャット	固有名詞
だんしんぐふらっしゅ	ダンシングフラッシュ	固有名詞
ぷりーずへるぷみー	プリーズヘルプミー	固有名詞
きてぃざへるぱー	キティ・ザ・ヘルパー	固有名詞
がろん	ガロン	人名
びーすときゃのん	ビーストキャノン	固有名詞
くらいむれいざー	クライムレイザー	固有名詞
みりおんふりっかー	ミリオンフリッカー	固有名詞
わいるどさーきゅらー	ワイルドサーキュラー	固有名詞
どらごんきゃのん	ドラゴンキャノン	固有名詞
もーめんとすらいす	モーメントスライス	固有名詞
みらーじゅぼでぃ	ミラージュボディ	固有名詞
じぇだ	ジェダ	名
どーま	ドーマ	姓
じぇだどーま	ジェダ=ドーマ	人名
でぃおせーが	ディオ=セーガ	固有名詞
ねろふぁてぃか	ネロ=ファティカ	固有名詞
いらすぴんた	イラ=スピンタ	固有名詞
いらぴあの	イラ=ピアノ	固有名詞
すぷれじお	スプレジオ	固有名詞
さんぐぇぱっさーれ	サングェ=パッサーレ	固有名詞
ふぃなーれろっそ	フィナーレ=ロッソ	固有名詞
ぷろゔぁでぃせるゔぉ	プロヴァディ=セルヴォ	固有名詞
さんとぅあーりお	サン=トゥアーリオ	固有名詞
れいれい	レイレイ	人名
りんりん	リンリン	人名
あんきほう	暗器砲	固有名詞
へんきょうき	返響器	固有名詞
せんぷうまい	旋風舞	固有名詞
ほうてんげき	放天撃	固有名詞
てんらいは	天雷破	固有名詞
ちれいとう	地霊刀	固有名詞
ちゅうかだん	中華弾	固有名詞
りもうこん	離猛魂	固有名詞
りりす	リリス	人名
そうるふらっしゅ	ソウルフラッシュ	固有名詞
しゃいにんぐぶれいど	シャイニングブレイド	固有名詞
めりーたーん	メリーターン	固有名詞
みすてぃっくあろー	ミスティックアロー	固有名詞
るみなすいりゅーじょん	ルミナスイリュージョン	固有名詞
るみなす	ルミナス	固有名詞
すぷれんだーらぶ	スプレンダーラブ	固有名詞
ぐるーみーぱぺっとしょう	グルーミーパペットショウ	固有名詞
まいんどれすどーる	マインドレスドール	固有名詞
みみっくどーる	ミミックドール	固有名詞
みらーどーる	ミラードール	固有名詞
もりがん	モリガン	名
あーんすらんど	アーンスランド	姓
もりがんあーんすらんど	モリガン=アーンスランド	人名
そうるふぃすと	ソウルフィスト	固有名詞
しゃどうぶれいど	シャドウブレイド	固有名詞
べくたーどれいん	ベクタードレイン	固有名詞
ばるきりーたーん	バルキリーターン	固有名詞
だーくねすいりゅーじょん	ダークネスイリュージョン	固有名詞
だくねす	ダクネス	固有名詞
ふぃにっしんぐしゃわー	フィニッシングシャワー	固有名詞
くりぷてぃっくにーどる	クリプティックニードル	固有名詞
あすとらるびじょん	アストラルビジョン	固有名詞
きゅーびー	Q-Bee	人名
しーあーる	C→R	固有名詞
でるたえー	ΔA	固有名詞
えすばいぴー	S☓p	固有名詞
あーるえむ	R.M.	固有名詞
おーえむ	O.M.	固有名詞
きゅーじぇー	QJ	固有名詞
ぷらすびー	+B	固有名詞
あいすくえあ	i²	固有名詞
さすかっち	サスカッチ	人名
びっぐぶれす	ビッグブレス	固有名詞
びっぐぶろう	ビッグブロウ	固有名詞
びっぐたいふーん	ビッグタイフーン	固有名詞
びっぐたわーず	ビッグタワーズ	固有名詞
びっぐぶらんち	ビッグブランチ	固有名詞
びっぐすいんぐ	ビッグスイング	固有名詞
びっぐふりーざー	ビッグフリーザー	固有名詞
びっぐあいすばーん	ビッグアイスバーン	固有名詞
びっぐとらっぷ	ビッグトラップ	固有名詞
びっぐすれっじ	ビッグスレッジ	固有名詞
びっぐれじすたー	ビッグレジスター	固有名詞
びっぐれじすたーうぃずまっぷす	ビッグレジスターウィズM.A.P.S	固有名詞
びくとる	ビクトル	名
げるでんはいむ	ゲルデンハイム	姓
びくとるふぉんげるでんはいむ	ビクトル=フォン=ゲルデンハイム	人名
めがふぉーりっど	メガフォーリッド	固有名詞
めがすていく	メガステイク	固有名詞
じゃいろくらっしゅ	ジャイロクラッシュ	固有名詞
ぎがばーん	ギガバーン	固有名詞
めがしょっく	メガショック	固有名詞
めがすぱいく	メガスパイク	固有名詞
ぐらびとんなっくる	グラビトンナックル	固有名詞
さんだーぶれいく	サンダーブレイク	固有名詞
げるでんはいむすりー	ゲルデンハイム3	固有名詞
ぐれーとげるでんはいむ	グレートゲルデンハイム	固有名詞
ざべる	ザベル	名
ざろっく	ザロック	姓
ざべるざろっく	ザベル=ザロック	人名
ですはりけーん	デスハリケーン	固有名詞
すかるすてぃんぐ	スカルスティング	固有名詞
ですふれーず	デスフレーズ	固有名詞
へるずげーと	ヘルズゲート	固有名詞
すかるぱにっしゅ	スカルパニッシュ	固有名詞
いーびるすくりーむ	イービルスクリーム	固有名詞
ですぼるてーじ	デスボルテージ	固有名詞
へるだんく	ヘルダンク	固有名詞
あるてぃめっとあんでっど	アルティメットアンデッド	固有名詞

